------------------------------------------------------------
------------------------------------------------------------
------------------------------------------------------------
------------------------------------------------------------
------------------------------------------------------------
------------------------------------------------------------
---------------GGGGGGB--------------------------------------
----------GGGGGMMMMMMM--------------------------------------
----------MMMMMMMMMMMM-----------------------------E--------
GGGGGB----MMMMMMMMMMMM--------GGGGGGGGGGGGGGGGGGGGGGGGGGGGGG