------------------------------------------------------------
------------------------------------------------------------
------------------------------------------------------------
------------------------------------------------------------
------------------------------------------------------------
------------------E---------GGG-----------------------------
--------------GGGGGGG----B----------------------------------
-------GGG--------------------------------------------------
-----GGMMM--------------------E--------------------E--------
GGGGGMMMMMGGGGGGGGGGGGGGGGGGGGGGGGGGGGGGGGGGGGGGGGGGGGGGGGGG