------------------------------------------------------------
------------------------------------------------------------
------------------------------------------------------------
------------------------------------------------------------
------------------------------------------------------------
------------------------------------------------------------
---------GGGGGG-----GGGGG-----B-----GGGGGG------------------
-------GGMMMMMM---------------------------------------------
------GMMMMMMMM-------------------------------------E-------
GGGGGGMMMMMMMMM-------------GGGGG----------GGGGGGGGGGGGGGGGG